###################
#.................#
#........#.....#..#
#.................#
#....#......#.....#
#.................#
#........##.......#
###..##############
###################